24 TV => 24tv
360 => 360
A NEWS => anews
A PARA => apara
A SPOR => aspor
A2 => a2
AHABER => ahaber
AKİT TV => akittv
AL JAZEERA CHANNEL => aljazeerachannel
AL JAZEERA INTERNATIONAL => aljazeerainternational
ATV => atv
BABY TV => babytv
BBC EARTH => bbcearth
BBC ENTERTAINMENT => bbcentertainment
BBC FIRST => bbcfirst
BBC WORLD NEWS => bbcworldnews
BENGÜTÜRK => benguturk
BEYAZ TV => beyaztv
BLOOMBERG => bloomberg
BLOOMBERG HT => bloomberght
BOOMERANG HD => boomeranghd
BRT 1 => brt1
BRT 2 => brt2
CADDE TV => caddetv
CARTOON NETWORK => cartoonnetwork
CBeebies => cbeebies
CGTN => cgtn
CGTN DOCUMENTARY => cgtndocumentary
CNBC-e => cnbce
CNN INTERNATIONAL => cnninternational
CNN TURK => cnnturk
DISCOVERY CHANNEL => discoverychannel
DISCOVERY SCIENCE => discoveryscience
DISNEY JUNIOR => disneyjunior
DMAX => dmax
Da Vinci => davinci
DİYANET TV => diyanettv
EKOL TV => ekoltv
EKOTURK => ekoturk
EMAX => emax
EURONEWS => euronews
EUROSPORT 1 => eurosport1
EUROSPORT 2 => eurosport2
FASHION TV => fashiontv
FB TV => fbtv
FLASH HABER => flashhaber
FOX => fox
FRANCE 24 => france24
GS TV => gstv
GZT => gzt
HABERGLOBAL => haberglobal
HABERTURK => haberturk
HALK TV => halktv
HT SPOR => htspor
KANAL 7 => kanal7
KANAL D => kanald
KRT TV => krttv
LİDER HABER TV => liderhabertv
MCM TOP => mcmtop
MEZZO => mezzo
MTV 00s => mtv00s
MTV HITS => mtvhits
MTV LIVE => mtvlive
MİNİKAGO => minikago
NAT.GEO.WILD => natgeowild
NATIONAL GEO. => nationalgeo
NICK JR => nickjr
NICKELODEON HD => nickelodeonhd
NICKELODEON SD => nickelodeonsd
NTV => ntv
RAI1 => rai1
SHOW TV => showtv
STAR TV => startv
Sports TV => sportstv
SÖZCÜ TV => sozcutv
TARİH TV => tarihtv
TELE 1 => tele1
TEVE2 => teve2
TGRT HABER => tgrthaber
TJK TV => tjktv
TLC => tlc
TRT  ARABI => trtarabi
TRT 1 => trt1
TRT 2 => trt2
TRT 3 / TRT SPOR => trt3trtspor
TRT AVAZ => trtavaz
TRT BELGESEL => trtbelgesel
TRT EBA TV LİSE => trtebatvlise
TRT EBA TV ORTAOKUL => trtebatvortaokul
TRT EBA TV İLKOKUL => trtebatvilkokul
TRT HABER => trthaber
TRT KURDI => trtkurdi
TRT MÜZİK => trtmuzik
TRT SPOR => trtspor
TRT SPOR YILDIZ => trtsporyildiz
TRT TURK => trtturk
TRT WORLD => trtworld
TRT ÇOCUK => trtcocuk
TV5 MONDE EUROPE => tv5mondeeurope
TV8 => tv8
TV8,5 => tv85
TVNET => tvnet
TYT TÜRK => tytturk
TÜRKHABER TV => turkhabertv
ULUSAL TV => ulusaltv
VAV TV => vavtv
YABAN TV => yabantv
beIN => bein
beIN GURME => beingurme
beIN H&E => beinhe
beIN MOVIES ACTION => beinmoviesaction
beIN MOVIES FAMILY => beinmoviesfamily
beIN MOVIES PREMIERE => beinmoviespremiere
beIN MOVIES STARS => beinmoviesstars
beIN MOVIES TURK => beinmoviesturk
beIN SERIES => beinseries
beIN SERIES 1 => beinseries1
beIN SERIES 2 => beinseries2
beIN SERIES 3 => beinseries3
beIN SERIES 4 => beinseries4
beIN SPORTS 1 => beinsports1
beIN SPORTS 2 => beinsports2
beIN SPORTS 3 => beinsports3
beIN SPORTS 4 => beinsports4
beIN SPORTS 5 => beinsports5
beIN SPORTS HABER => beinsportshaber
beIN SPORTS MAX 1 => beinsportsmax1
beIN SPORTS MAX 2 => beinsportsmax2
beIN İZ => beiniz
tv100 => tv100
ÜLKE TV => ulketv
